NAME:zxc
000000000000000000000000000000000000000000000000
000000000000000000000000000000000000000000000000
000000000000000000000000000000000000000000000000
000000000000000000000000000000000000000000000000
000008000800080008000800000000000000000000000000
000001000800080008000800000000000000000000000000
000001000100080008000800000000000000000000000000
000001000100010008000800000000000000000000000000
000001000100010001000800000000000000000000000000
000001000100010001000100000000000000000000000000
000001000100010001000100000000000000000000000000
000001000100010001000100000000000000000000000000
000001000100010001000100000000000000000000000000
000001000100010001000100000000000000000000000000
000001000100010001000100000000000000000000000000
000001000100010001000100000000000000000000000000
000001000100010001000100000000000000000000000000
000001000100010001000100000000000000000000000000
000001000100010001000100000000000000000000000000
000001000100010001000100000000000000000000000000
000001000100010001000100000000000800080008000800
000001000100010001000100000000000100080008000800
000001000100010001000100000000000100010008000800
000001000100010001000100000000000100010001000800
000000000000000000000000000000000000000000000000
DISTRICTS:3
