NAME:PHILROODELPHIA
000000000000000000000000000000000000000000000000
000000000000000000000000000000000000000000000000
000000000000000000000000000000000000000000000000
000000000000000000000000000000000000000000000000
000000000000000000000000000000000000000000000000
000000000707060207030702030307070602060200000000
000000000305060503130204100604030506070300000000
000000000306040706020202020602061304050300000000
000000000705090202030702060702060303060700000000
000000000703020306030202060309020706021000000000
000000000202080313070706030703020202040200000000
000000000313060703020614100702031306020600000000
000000000304020702061402070307060507040300000000
000000000706071007060207070706030306040700000000
000000000202060303070203070603100203130700000000
000000001005060903071303030603070301030200000000
000000000706070703060602020202030603050600000000
000000000905051006030710060603130609020700000000
000000000707020706070403060706040302050200000000
000000000206070207020703020606030702060700000000
000000000000000000000000000000000000000000000000
000000000000000000000000000000000000000000000000
000000000000000000000000000000000000000000000000
000000000000000000000000000000000000000000000000
000000000000000000000000000000000000000000000000
DISTRICTS:8