NAME:City 17
000000000000000000000000000000000000000000000000
000000000000000000000000000000000000000000000000
000000000000000000000000000000000000000000000000
000000000000000000000000000000000000000000000000
000000000000000000000000000000000000000000000000
000000000000000000000000000000000000000000000000
000000000000000000000000000000000000000000000000
000000000000000000000000000000000000000000000000
000000000901070707070607070207020707050900000000
000000000101020406080406020708020208050500000000
000000000101060207020207060202020606040800000000
000000000101060608020706060806060204020400000000
000000000201060602060702060602060606080200000000
000000000101070707070304080202020202020200000000
000000000101070707070407060202070707070700000000
000000000101070703070407040202070707070700000000
000000000901070707070706060202070707070700000000
000000000000000000000000000000000000000000000000
000000000000000000000000000000000000000000000000
000000000000000000000000000000000000000000000000
000000000000000000000000000000000000000000000000
000000000000000000000000000000000000000000000000
000000000000000000000000000000000000000000000000
000000000000000000000000000000000000000000000000
000000000000000000000000000000000000000000000000
DISTRICTS:4	