NAME:ROOSON CITY
000000000000000000000000000000000000000000000000
000000000000000000000000000000000000000000000000
000000000000000000000000000000000000000000000000
000000000000000000000000000000000000000000000000
000000000000080808000000010101000000000000000000
000000000001050404010008010107080000000000000000
000000000001040406010008070807080000000000000000
000000000001040604010008070501080000000000000000
000000000000080808080808010101000000000000000000
000000000000000001030803010000000000000000000000
000000000000000001070607010000000000000000000000
000000000000000001030103010000000000000000000000
000000000000010101080808080808000000000000000000
000000000008030303080001050405010000000000000000
000000000008030703080001040504010000000000000000
000000000008080307080001050405010000000000000000
000000000000010101000000080808000000000000000000
000000000000000000000000000000000000000000000000
000000000000000000000000000000000000000000000000
000000000000000000000000000000000000000000000000
000000000000000000000000000000000000000000000000
000000000000000000000000000000000000000000000000
000000000000000000000000000000000000000000000000
000000000000000000000000000000000000000000000000
000000000000000000000000000000000000000000000000
DISTRICTS:5