NAME:ROOSIC
000000000000000000000000000000000000000000000000
000000000000000000000000000000000000000000000000
000000000000000000000000000000000000000000000000
000000000000000000000000000000000000000000000000
000000000000000000000000000000000000000000000000
000000000000000000000000000000000000000000000000
000000000000000000000000000000000000000000000000
000000000000000000000702070000000000000000000000
000000000000000000020306040200000000000000000000
000000000000000702080303020702070000000000000000
000000000000020607070403060707030200000000000000
000000000702030408020307010408040602020000000000
000000020307070812080306030812080703040200000000
000000000202040408030303070208040702070000000000
000000000000020803070304030604070200000000000000
000000000000000702060306080307020000000000000000
000000000000000000020702010200000000000000000000
000000000000000000000207070000000000000000000000
000000000000000000000000000000000000000000000000
000000000000000000000000000000000000000000000000
000000000000000000000000000000000000000000000000
000000000000000000000000000000000000000000000000
000000000000000000000000000000000000000000000000
000000000000000000000000000000000000000000000000
000000000000000000000000000000000000000000000000
DISTRICTS:4