NAME:FORTY ROOT
000000000000000000000000000000000000000000000000
000000000000000000000000000000000000000000000000
000000000000000000000000000000000000000000000000
000000000000000000000000000000000000000000000000
000000000000000000000000000000000000000000000000
000000000000000000000000000000000000000000000000
000000000000000000000000000000000000000000000000
000000000007080802130707050602050706020000000000
000000000002050207070503080706030407030000000000
000000000008020704070204060702030906040000000000
000000000002070302060702050302050602030000000000
000000000004070709060703070403070307080000000000
000000000003020208020602080702060704020000000000
000000000002030706030703071307070203020000000000
000000000005020302070207030702030706070000000000
000000000007030207020709090208070302030000000000
000000000000000000000000000000000000000000000000
000000000000000000000000000000000000000000000000
000000000000000000000000000000000000000000000000
000000000000000000000000000000000000000000000000
000000000000000000000000000000000000000000000000
000000000000000000000000000000000000000000000000
000000000000000000000000000000000000000000000000
000000000000000000000000000000000000000000000000
000000000000000000000000000000000000000000000000
DISTRICTS:5