NAME:EXROOTER
000000000000000000000000000000000000000000000000
000000000000000000000000000000000000000000000000
000000000000000000000000000000000000000000000000
000000000000000000000000000000000000000000000000
000000000000000000000000000000000000000000000000
000000000000000000000000000000000000000000000000
000000000000000405050403030303030000000000000000
000000000000000603060605050101010000000000000000
000000000000000803080605050501010000000000000000
000000000000000303030305050505140000000000000000
000000000000000303030803050305050000000000000000
000000000000000308030303050305050000000000000000
000000000000000803030303050305050000000000000000
000000000000000405030503051004050000000000000000
000000000000000504050505040405050000000000000000
000000000000000505010501050504050000000000000000
000000000000000105050405010405040000000000000000
000000000000000000000000000000000000000000000000
000000000000000000000000000000000000000000000000
000000000000000000000000000000000000000000000000
000000000000000000000000000000000000000000000000
000000000000000000000000000000000000000000000000
000000000000000000000000000000000000000000000000
000000000000000000000000000000000000000000000000
000000000000000000000000000000000000000000000000
DISTRICTS:3