NAME:MURROOSVILLE
000000000000000000000000000000000000000000000000
000000000000000000000000000000000000000000000000
000000000000000000000000000000000000000000000000
000000000000000000000000000000000000000000000000
000000000000000000000000000000000000000000000000
000001030101080701070801010807010705010804010000
000003040107060702030407070605030507010408070000
000008070208010407010807070107050808040208080000
000001020204060203020602030702020201080401040000
000001060201010803080407080608030804020205060000
000007030808050507010801050107080601020805010000
000001050507020802070205070206020802070802030000
000005070202010701020108080601070702070802030000
000007020108080707080303050201070207030702010000
000005080303080102060201070607020803010708010000
000001080107020608070802020801060207040705010000
000001020802020701080506080707040102020506010000
000004080308020705060108020803070806050804060000
000008030801010802020102040101020402010406080000
000001080108080107010807010408080104070806010000
000000000000000000000000000000000000000000000000
000000000000000000000000000000000000000000000000
000000000000000000000000000000000000000000000000
000000000000000000000000000000000000000000000000
000000000000000000000000000000000000000000000000
DISTRICTS:6